#        #
##      ##
# ###### ##
#  #  $   #
#         ###
######$     #
#           ##      #
#            ####   ##
#              #    ##
#              ###  ##
##             ###  ##
 ############### ####
