                    
   $                
   #                
   ###              
   # #####          
   ###   #          
     ##  #          
     ### #          
   #########        
   #  ##   ####$     
   #   #   # #      
$#######   ###      
  #    #   #        
  #    #########    
  ###      #   #    
   ###     #   #    
   ############# 
